111111111111111
1P0011111111001
101000000001101
101011010111101
100010010010001
101110011110101
101000000000101
101111011111101
100001000000001
101101111110101
100000000000001
101111111111101
111111111111111