11111
1P101
111C1
11E11
10001
11111
