11111111111111
1P10111111E101
111C0000000C01
10101101011101
1C001001001C01
10111001111001
101C0000000C01
11111111111111
