11111111111111
1P00111111E101
100C0000000C01
10101101011101
1C001001001C01
10111001111001
101C000000XC01
11111111111111
