11111111111111111111111111111111111111111111111111111111111111111111111111111111111111111111111111111111
1E0000000000000C00000C0000000000000C00000C0000000000000C00000C0000000000000C00000C00000000000CC000000001
111001010010000010100100000001010000101001000000010100001010010000000101000010100100000001010CC000000001
101001001110101000100100000001010010001001000000010100100010010000000101001000100100000001010CC000000001
100000000C00C0000000000000000000C0000000000000000000C0000000000000000000C0000000000000000000CCC000000001
100000000000000C00000C0000000000000C00000C0000000000000C00000C0000000000000C00000C00000000000CC000000001
111001010010000010100100000001010000101001000000010100001010010000000101000010100100000001010CC000000001
101001001110101000100100000001010010001001000000010100100010010000000101001000100100000001010CC000000001
100000000C00C0000000000000000000C0000000000000000000C0000000000000000000C0000000000000000000CCC000000001
100000000000000C00000C0000000000000C00000C0000000000000C00000C0000000000000C00000C00000000000CC000000001
111001010010000010100100000001010000101001000000010100001010010000000101000010100100000001010CC000000001
101001001110101000100100000001010010001001000000010100100010010000000101001000100100000001010CC000000001
100000000C00C0000000000000000000C0000000000000000000C0000000000000000000C0000000000000000000CCC000000001
100000000000000C00000C0000000000000C00000C0000000000000C00000C0000000000000C00000C00000000000CC000000001
111001010010000010100100000001010000101001000000010100001010010000000101000010100100000001010CC000000001
101001001110101000100100000001010010001001000000010100100010010000000101001000100100000001010CC000000001
100000000000000C00000C0000000000000C00000C0000000000000C00000C0000000000000C00000C00000000000CC000000001
111001010010000010100100000001010000101001000000010100001010010000000101000010100100000001010CC000000001
101001001110101000100100000001010010001001000000010100100010010000000101001000100100000001010CC000000001
100000000C00C0000000000000000000C0000000000000000000C0000000000000000000C0000000000000000000CCC000000001
100000000000000C00000C0000000000000C00000C0000000000000C00000C0000000000000C00000C00000000000CC000000001
111001010010000010100100000001010000101001000000010100001010010000000101000010100100000001010CC000000001
101001001110101000100100000001010010001001000000010100100010010000000101001000100100000001010CC000000001
100000000C00C0000000000000000000C0000000000000000000C0000000000000000000C0000000000000000000CCC000000001
100000000000000C00000C0000000000000C00000C0000000000000C00000C0000000000000C00000C00000000000CC000000001
100000000C00C0000000000000000000C0000000000000000000C0000000000000000000C0000000000000000000CCC000000P01
11111111111111111111111111111111111111111111111111111111111111111111111111111111111111111111111111111111
